NO ./textures/stelle.xpm
SO ./textures/dank.xpm
WE ./textures/february.xpm
EA ./textures/kiosk.xpm
F 120, 120, 120
C 184, 235, 245

11111
100S1
10001
10011
11111