NO ./textures/dan_heng.xpm
SO ./textures/dan_heng_lc.xpm
WE ./textures/march.xpm
EA ./textures/sampo.xpm
F 79, 79, 79
C 161, 204, 180

11111
10001
10W01
10011
11111