NO ./textures/player.xpm
SO ./textures/player.xpm
WE ./textures/player.xpm
EA ./textures/player.xpm
F 50, 50, 50
C 150, 150, 150

111111111111111111111111111111
101000100000000101000100000001
100010001000000101000100000001
101010100000000101000100000001
100100110000000101000100000001
111101000000000000000000000001
100001000000000000000000000001
101101000000000N00000000000001
100100000000000000000000000001
100100000000000000000000000001
100100000000000000000000000001
101010100000000101000100000001
101010100000000101000100000001
101010100000000101000100000001
101010100000000101000100000001
101010100000000101000100000001
101010100000000101000100000001
100100000000000000000000000001
100100000000000000000000000001
100100000000000000000000000001
111111111111111111111111111111