NO ./textures/dan_heng_lc.xpm
SO ./textures/dan_heng_lc.xpm
WE ./textures/dan_heng_lc.xpm
EA ./textures/dan_heng_lc.xpm
F 65,64,82
C 75,109,136

111111111
110E00101
100000001
100100011
111111111