C 0,173,2
WE textures/acacia_log.xpm
EA textures/dirt_1.xpm
NO textures/ancient_debris_side.xpm
SO textures/chorus_flower.xpm
F 255,255,255

111111111111
100100100101
10N200200201
100100100101
111111111111