NO ./path_north
SO ./path_south
WE ./path_west
EA ./path_east
F 255,255,255
C 0,173,2

111111111111
100000000001
10E000000001
100000000001
111111111111