NO ./textures/budding_amethyst.xpm
SO ./textures/basalt_top.xpm
WE ./textures/chorus_flower.xpm
EA ./textures/black_glazed_terracotta.xpm
F 150, 35, 35
C 154, 121, 214

11111
10001
100011111111
10E000000001
111111111111