NO ./textures/player.xpm
SO ./textures/player.xpm
WE ./textures/player.xpm
EA ./textures/player.xpm
F 255,255,255
C 0,173,2

11111
10001
100011111111
10E000000001
111111111111