NO ../textures/ancient_debris_side.xpm
SO ../textures/prismarine_bricks_1.xpm
WE ../textures/acacia_log.xpm
EA ../textures/dirt_1.xpm
F 255,255,255
C 0,173,2

111111111111
100000000001
10N000000001
100000000001
111111111111