NO ./textures/player.xpm
SO ./textures/player.xpm
WE ./textures/player.xpm
EA ./textures/player.xpm
C 0, 128, 128
F 255, 127, 80

  111111111
111100100011
10000110S001
100100000011
11111111111