NO ./path_north
SO ./path_south
WE ./path_west
EA ./path_east
F 255,255,255
C 0,173,2

  111111111
111100100011
10N001101001
100100000111
1111111111