NO ./path_north
SO ./path_south
WE ./path_west
EA ./path_east
F 255,255,255
C 0,173,2

  111111111
111100100011
10000110S001
100100000011
11111111111