NO ../textures/ancient_debris_side.xpm
SO ../textures/prismarine_bricks_1.xpm
WE ../textures/acacia_log.xpm
EA ../textures/dirt_1.xpm
F 176,206,100
C 160,173,2

  111111111
111100100011
10000110S001
100100000011
11111111111