WE ./textures/seele.xpm
EA ./textures/seele.xpm
NO ./textures/seele.xpm
SO ./textures/seele.xpm
C 34,28,72
F 34,28,72

11111
10001
10S01
10011
11111