WE ./textures/shrek.xpm
EA ./textures/shrek.xpm
NO ./textures/shrek.xpm
SO ./textures/shrek.xpm
C 179,172,39
F 179,172,39

11111
10001
10S01
10011
11111