WE ./textures/basalt_top.xpm
EA ./textures/debug2.xpm
NO ./textures/gilded_blackstone.xpm
SO ./textures/black_glazed_terracotta.xpm
C 0, 128, 128
F 255, 127, 80

11111
10001
10S01
10011
11111