C 0,173,2
WE ./path_west
EA ./path_east
NO ./path_north
F 255,255,255
SO ./path_south

  1111111
  1000001
  1010001
111010001
10N000011
111111111