WE ./textures/basalt_top.xpm
EA ./textures/debug2.xpm
NO ./textures/gilded_blackstone.xpm
SO ./textures/seele.xpm
C 0,173,2
F 255,255,255

11111
100S1
10001
10011
11111