NO ./path_north
SO ./path_south
WE ./path_west
EA ./path_east

F 255,255,255
C 0,173,2

111
101
101  1         
101111
100001
101001
1000111111
1000N00001
11111111111