WE ./textures/gilded_blackstone.xpm
EA ./textures/black_glazed_terracotta.xpm
NO ./textures/basalt_top.xpm
SO ./textures/budding_amethyst.xpm
C 0,0,0
F 148,8,3

11111
10001
10S01
10011
11111