C 0,173,2
WE ./path_west
EA ./path_east
NO ./path_north
F 255,255,255
SO ./path_south

    11111
    10001
    10001
111110001
10N000011
111111111