C 0,173,2
WE ./path_west
SO ./path_south
EA ./path_east
NO ./path_north
F 255,255,255

  11111
1110001111
111110011
1000001111
1111111