NO ./path_north
SO ./path_south
WE ./path_west
EA ./path_east
F 255,255,255
C 0,173,2

      11111
    11100011
111110S0011
1000001111
1111111