NO ./path_north
SO ./path_south
WE ./path_west
EA ./path_east

F 255,255,255
C 0,173,2

11111
10001
10001
10N00
11111