NO ./textures/diamond_block.xpm
SO ./textures/gilded_blackstone.xpm
WE ./textures/diamond_block.xpm
EA ./textures/gilded_blackstone.xpm
F 93, 238, 226
C 61, 58, 68

11111
100S1
10001
10011
11111